###########
S       # #
# ## ## # #
# #    ## #
######    #
# #   ### #
# # #   # #
#   ###   #
# # # # ###
# # #     #
###E#######